1111111111111111111111111111111
1101110111011101110111011101111
100000000000000000000000C000C01
1101110111011101110111011101111
1101110111011101110111011101111
1000000000000000000000000000001
11C1110111011101110111011101111
1101110111011101110111011101111
1000000000000000000000000000001
1101110111011101110111011101111
1101110111011101110111011101111
1000000000000000000000000000001
11011101110111011101110111C1111
1101110111011101110111011101111
1000000000000000000000000000001
1101110111P11101110111011101111
1101110111011101110111011101111
1000000000000000000000000000001
1101110111011101110111011101111
1101110111011101110111011101111
100000000000000000000000000EC01
1101110111011101110111011101111
1101110111011101110111011101111
1000000000000000000000000000001
1101110111011101110111011101111
1101110111011101110111011101111
1000000000000000000000000000001
1101110111011101110111011101111
1101110111011101110111011101111
1101110111011101110111011101111
1111111111111111111111111111111