111111111
100000001
100000011
10C00E1P1
111111111