111111111
100000001
100000001
10000E0P1
111111111