111111111
100000001
100000001
10C0000P1
111111111