111111111
10P000001
100000001
10C00E0P1
111111111