111111111
100000001
100000001
10C00E0P0
111111111