11111
1E111
10111
1P111
1T111
1CCC1
11111