11111111111111111111111111111111111111111111111111111111111111111111111111111111111111111111111111111
11111111000000111000001111111111111111111111111111111111111111111111111111111111110000111111111111111
11111111000000111000001100000111111111111111111111111111111111111111111111111111110000111111111111111
11111111000000000000000000000000000000000000000000000000000000000000000000000000000000011111111111111
11111111000000111000001100000111111111111111111111111111111111111111111111101111110000011100011111111
11111000000000111000001100000000001111111111111111111100000001111111111111101111111101011100011111111
11111000111111111110111100000111101111111111000011111100000001111111111111101111111101011100011111111
111110001111110000000111000001111P1111110000000000000000000000000000000000000000000000000000011111111
11111000000000000000000000000000000000010111000000000000000000101111111111101111111101011100011111111
11111000000011000000000000000000000000000000000000000000000000000000000000000000000000000000000011111
11111000000011000000011000000000000000000000000000111111100000000111111111101111111000011110111011111
11111000000011000000011000001111100000000000000000000000000000000111111100000000000000011110111011111
11110000000011111010000000000000000000000011110000000001100000000111111101101111111000011110111011111
11110101000011111011111110011111100000000011110000000000000000000000000100000000111100011110111011111
11110101000011111011111110011111100000000011110000000001100000000000100100000000111100011110111011111
11110101000011111010000010011111101101010111110000110000000000000000000000000000111100011110000011111
1111E101110100000000000000000000000000000000000000000000000000000000000000000000111100011110000011111
1111010111010000000000000000000000000000000000000000000000000000000000000110011000C100011110000011111
11110101000000000000000000000000000000000000000000000000000000000000000000000000000000011110000000111
11110101000000000000000000000000000000000000000000000000000000000000000000000000000000011110000000001
11110101000000000000000010011110000000000000000000000000000000000000000000000000000000011110000000001
11110100000000000000000000000000000000000000000000000000C00000000000000000000000000000000000000000001
11110101000011001011001010000111001000000001110000000111000000000001101101100111101000001110101000001
11110101000011001011001010000110000001010101110000000111000000000001101101100111101000001110101000001
11110101000011001011001010000000000000000000000000000000000000000000000000000000000000001110101010011
10000101010111001011001010000100000001010001110100110111100000000001101101100001101000001110101010011
10000000000111001011001010000100000000000000000000000000000000000000000000000000000000000000000000011
10000000000000000000000000000000000000000000000000000000000000000000000000000001101000000000000000011
10000000000111001000000000000000000000000000000000000000000000000000000000000000000000000000000000011
10000000110111000000000000000000000000000000000000000000000000000000000000100001101000010000000000011
11010000100000011010000000001100000101010000000000000000000000000000000000100001101000011010000000011
11010000000000000000000000000000000000000000000000000000000000000000000000000000000000000000101010011
11010000100000000000000000000000000000000000000000110110000010100110000101100011101000011000101010011
11010101100000000000000000000000000000000000000010110110000010100111101101100011101000011000100000011
11010101110001010010001010001100000101010000000010110111000010100111101101100011101000011000100000011
11010000010001010010001010001100000101010000000000000000000000000110000101100011101000011000100000011
11010000010000000011101000000000000101010000000010110111000010000110000101100011000000011000100000011
11010000000000000000000000000000000000000000000000000000000010000110000101100011000000011000100000011
11010000010000000000000000000000000000000000000000000000000000000000000000000000000000001000101010011
11010000010000000000000000000000001000000001100010110000000110000110000100000001000000001000101010011
11010000110000000000000000000000000000000000000000000000000000000000000000000000000000001000000000011
11010000000000110000000000000001001000000001000000000000000000000000000000000000000000000000000000011
11010000000000000000000000000000000000000000000000010000000110000111100100000001100010111100000000011
11010000000000000000000000000000000000000000000000000000000000000000000000000000000000000000000000011
11010000110101110011101010001101001100000001000000110000000110000111100101100011100010111100000000011
11010000110101110011100010001101001100000000000000110111000010000111100101100011100010111100000000011
11010000110101110011100010001101001100000001000000000000000010000100000001100011100010111100000000011
11000000000000000000000000000000000000000000000000000000000000000000000000000000000000000000000000011
11110100110101110011100010001101001101000001000001110111011110000100000001100010000010111100101010111
11110100000101000011100010001101001101000001100011110110000000000011100101100010000010111100000010111
11000100000101000000000010001100000000000000000000000000000000000011100101100000000010111100000010111
11000100000000000000000000001100000001000001100011110110000000000011100101100010000010111100000010111
11000100000000000000000000000000000000000000000000000000000000000000000000000000000000000000000010111
11000000000000000000000000000000000000000000000000000000000000000000000000000000000000000000000000111
11000100010101000000000000001100000001000001100011110111010010000011000000000000000000000000000000111
11000100000101111000000000001100000001000001100011110111010010000011000000000011000000000000000000111
11000100000101111000000000001101001101000001100011110111010010000111100000100011000000000001111000111
11100100000101111010100000001101000001000001100000000111010000000000000000000000000000000001111000111
11100100000101111010100000000000000000000000000000000000000000000000000000000000000000000001111000111
11100100010101111010100000001101000001000001000000000111011010000111100000100011010000000001111000111
11100100010101111010100000001101000011000001000000000000000000000000000000000011010010101101111000111
11100100010101111010100000001101000011000000000000000111011010000111100001100011010010101101100000111
11100100010101111010100000001101000111010001000000000111011010000111100000000001010010101101100000111
11100100000000000000000000000000000000000000000000000000000000000000000000000000000000001101100000111
11100100000000011010100000000000000000000000000000000000000000000000000000000000000000000000000000111
11100100000000011010100000000000000000000000000000000000C00000000000000000000000000000111101100000111
11100100000000011010101000000001000001010001100011010111010000000000000000000000000000000000100000111
11100100000000000000000000000000000000000000000000000000000000000111100001000001010010100000100000111
11100100000000011010101000000000000000000000000000000000000000000000000000000000000000000000111000111
11100100000000000000101000000001000001010C01100011010110000110100111000001000001010010100000110000001
11100100010111100000000000000000000000000000000000000000000000000000000001000001010010101001110000001
11100000000000000000000000000000000000000000000000000000000000000000000000000000000000000000000000001
11100000010110000000000000000000000000000000000000000000000000000000000000000000000010101001110000001
11100000000000000000000000000000000000000000000010000000000110101101110001000011010000101001110000001
11100000010110000000000000000000000000000000000000000000000000000000000000000000000000000001111000111
11101100010110000000100001001000010111010000000000011111110110101101110001000000000000100000001000111
11101100000000000000000000000000000000000000000000000000000000000000000000000011010000100000001000111
11101100010110111010100001101000010000000000000000000000000000000000000000000000000000000000001000111
11101100010110111010101001101111010000000000000000000000000000000000C00000000000000000100000001000111
11101100010000011010101001101111010000010000000001011111110000001101110101001011010011100000001000111
11101100010000011010100001101000000011110000000000011111110000001000110101001011010011101111111000111
11101100010000011010100000000000000000000000000000000000000000001000110101001011010011101111111000011
11101100000000000000000000000000000000000000000000000000000000000000000000000000000000000000000000011
11101101010000011011100001101000000011100000100000011111110000001000110110001011000000101111111000011
11101101010000011011100000000000000000000000000000000000000000000000000000001011000000101111111001111
11101101010000010001101111101111010111100000100001011111110111101111110110001011000000101111111001111
11101101010110110001100000000000000000000000000000000000000000000000000000000000000000000000000001111
11101101010110110000000000000000000000000000000000011110000001101111110111101011000000101111111001111
11100000000110110001111111101110000001100000100001111110000001101111110111101011000000101111111001111
11100000000110111011111111101110000001100011100001111110000001101111110111101011010111101111111001111
11100000000110111011111000000000000000000000000000000000000001101111110111101011010000101111111001111
11100000000000000000000000000000000000000000000000000000000000000000000000000000000000000000000001111
11100000000000000011000000101100000111000001100001111110000001101111110100000000000000101111110000111
11100000000000000000000000000000000111000001100001111111111111101111110100000001010111101111110000111
11100000000000000000000000000000000000000000000001111111111100000011110111111011010111000111110000111
11111100000000000000000000000000000000000000000000000000000000000000000000000000000000000000000000111
11110000010000000111000000100000000000000000000000000000000000000000000000000000000000000111110000111
11110000010000000111111111111111111111111000000000000000000000000000000000000000000000111111110000111
11110000000000000000000000000000000000000000000000000000000000000000000000000011111111111111111111111
11110000011111111111111111111111111111111000000000111111111111111110000001111111111111111111111111111
11111111111111111111111111111111111111111111111111111111111111111111111111111111111111111111111111111