111111111
100000001
100001101
10000ECP1
111111111