111111111
100000C01
100001111
10C00E0P1
111111111