11111111111
1110E1C0111
11110101111
11110101111
1100C0C0011
11111C11111
1110P000111
10001110001
100111110C1
11111111111
11111111111