111111111111111111111111111111111111111111111111111
100010000010000000001P0000C000100010000000000000101
111011101011111011101010111110101010111111111110101
101010001000000010101010000010001010001010000000101
101010111111111110101011111011111010101010111111101
1010001000100000100010000010100000101010101C0000101
10111110101010101011111011101011111110101010111C101
101000101010101010000010100010001000001000101010001
101010101010101111111011101111101011111011101011101
10E01000100010000C0C0000001000000010000000001000001
111111111111111111111111111111111111111111111111111