111111111111111111111111111111111111111111111111111
111111111111111111111111111111111111111111111111111
111111111111111111111111111111111111111111111111111
111111111111111111111111111111111111111111111111111
111111111111111111111111111111111111111111111111111
111111111111111111111111111111111111111111111111111
111111111111111111111111111111111111111111111111111
111111111111111111111111111111111111111111111111111
111111111111111111111111111111111111111111111111111
111111111111111111101111111111101111111111111111111
111111111111111111101111111111101111111111111111111
1111111111111111110010111111101C0111111111111111111
111111111111111110100001111100001011111111111111111
11111110111111110C101011111110101001111111101111111
111111100001111100001010111010100001111100001111111
111111100100011100010010111010010001110001001111111
111111110100100110E10010010010010011001001011111111
111111111110000000000100111001000000000011111111111
111111111111101001100110111011001100101111111111111
111111111110000001100000010000001100C00011111111111
1111111111111C0111111110010011111111001111111111111
11111111111111001111111101011111111CP11111111111111
111111111111111011111110010011111110111111111111111
111111111111111111111100010001111111111111111111111
111111111111111111111110000011111111111111111111111
111111111111111111111111000111111111111111111111111
111111111111111111111111000111111111111111111111111
111111111111111111111111111111111111111111111111111
111111111111111111111111111111111111111111111111111
111111111111111111111111111111111111111111111111111
111111111111111111111111111111111111111111111111111
111111111111111111111111111111111111111111111111111
111111111111111111111111111111111111111111111111111
111111111111111111111111111111111111111111111111111
111111111111111111111111111111111111111111111111111
111111111111111111111111111111111111111111111111111
111111111111111111111111111111111111111111111111111
111111111111111111111111111111111111111111111111111
111111111111111111111111111111111111111111111111111
111111111111111111111111111111111111111111111111111
111111111111111111111111111111111111111111111111111
111111111111111111111111111111111111111111111111111
111111111111111111111111111111111111111111111111111
111111111111111111111111111111111111111111111111111
111111111111111111111111111111111111111111111111111
111111111111111111111111111111111111111111111111111
111111111111111111111111111111111111111111111111111
111111111111111111111111111111111111111111111111111
111111111111111111111111111111111111111111111111111
111111111111111111111111111111111111111111111111111
111111111111111111111111111111111111111111111111111